Army top - Armor piercing
Basic Jacket - HP & Armor
Bracers - 1x Invincible
Business Top - +4 Attack
Cat Bag - 
Choker - [2] Choke Enemy
Combat Boot - 1x 5 dice attack
Combat Pants - Gain 1 attack each turn
Fishnet Leggings
Fluffy Jacket - Taunt
Future Top - [2] Laser Attack at all enemies
Murder Gloves - When any character dies, deal 1 hit
Gold Belt - Tactical reload
Gold Chain - Remove debuffs?
Goth Boot - [1] All attack
Groovy Pants - +4 HP
Gucci Belt - [4] double your attack
Hair Sword - x3 Quick Attack and Go Again
Heartbreaker - Gift +1 attack on entry
Heels - Armor piercing attack
Hoops - +1 Swag Gain
Hotpants - instant 2 hits
Jean Jacket - 1x Lifestrike
Jeans - [2] Accurate kick
Jewel Necklace - [2] Power Up Ally
Leggings - Heal each turn
Mace - +1 Armor
Medic Bag - [2] Heal
Mesh Top - +Armor +HP
Mime - Invisible Wall, Gain Armor
Mirror Top - Buff all allies
Off-Shoulder Top - 

Jewel Necklace - 1x Gain Extra Action